11111111111111111111111111111111
10100101001000011000000100000011
10000001101001000001000110100011
11001100000100100000111101100101
10101110001100000000000001000001
10001010110000000100000010110001
10001011100000000000110011010101
11111010110000000001111001001101
11000001100000000010011001101011
10100000011010101000101000011001
10100110100011000000001010010011
10000100101000011100001001000001
10011100110000000100010100010111
11101000000100000001001001100101
10010001110000010100010100000001
10110100100000111011010011001001
10110000110000000001100000011001
10010010000110000001000101010001
10000001000110000000110000000001
11100100000011101100001110010001
10000011000000001100000000000011
10111010000000000010000000000001
10110100001000010000100000010001
11111111111111111111111111111111